11111111
100E0C01
100000P1
11111111