11111111
100E0C01
100CC0P1
11111111