11111111
100EC001
100000P1
11111111